1 13 13
###########
#pw *  *t #
# # 5 #t# #
#  **     #
# # # # # #
# * 6 **  #
# #   # # #
#*  *   2 #
# # # # #*#
#*    **  #
# #*# # # #
#     1   #
###########