1 13 31
###############################
#p  *  ** *  1 * 2 s  *  *    #
# #   #*# # #*#*# # # # # #*# #
#  **     ***  *  1   *   *   #
# # # # # #*# # #*#*# # # # #*#
# *   **   * b*1 *  x         #
# #   # # # # # # #*# #*# # # #
#*  *   2  *  *   *  *      * #
# # # # #*# # # #*# # # #*# # #
#*    **  *   *   **2 *#*    #
# #*# # # # #*# #*# #*# #*# # #
#     1     *   ***       *   #
# ## #* # # #*# #*# #*# #*# # #
# *###  * f  2# *   # * # # # #
###############################