1 15 21
#####################
#p f*  ** *  1 *#*# #
# # # #t# # #*#*# # #
#  ** 1 *5*  ** #*# #
# # # # # #*# #*# # #
# *   **   s* b6#*# #
# # # # # # # #*# #*#
#*  *   2  *  * #*# #
# # # # #*# # # #*  #
#*    **  * 1 * # * #
# #*# # # #x#*# # #*#
#d 2* 1     *w  #** #
# #*#*# # # #*# #*  #
# * **  *       # # #
#####################
