1 15 31
###############################
#p  *  ** *  1 * 2 s  *  *    #
# #   #*# # #*#*# # # # # #*# #
#  **     ***  *  1   *   *   #
# # # # # #*# # #*#*# # # # #*#
# *   **   s* b*1 *  x         #
# #   # # # # # # #*# #*# # # #
#*  *   2  *  *   *  *      * #
# # # # #*# # # #*# # # #*# # #
#*    **  *   *   **2 *#*    #
# #*# # # # #*# #*# #*# #*# # #
#     1     *   ***       *   #
#  * #* # # #*# #*# #*# #*# # #
# *# #  * f  2# *   # * # # # #
###############################