1 13 13
###########
#p  *  *t #
# #   #t# #
#  **     #
# # # # # #
# *   **  #
# #   # # #
#*  *   2 #
# # # # #*#
#*    **  #
# #*# # # #
#     1   #
###########