1 15 31
###############################
#p  *  *t *  1 * 2 s  *  *    #
# #   #t# # #*#*# # # # # #*# #
#  **     ***  *  1   *   *   #
# # # # # #*# # #*#*# # # # #*#
# *   **   s* b*1 *  x        #
# #   # # # # # # #*# #*# # # #
#*  *   2  *  *   *  *      * #
# # # # #*# # # #*# # # #*# # #
#*    **  *   *   **2 *#*     #
# #*# # # # #*# #*# #*# #*# # #
#     1     *   ***       *   #
#  * #* # # #*# #*# #*# #*# # #
# *# #  * f  2# *   # * # # # #
###############################