1 25 13
#############
#p *    **  #
# # # #*# # #
# * x  2 *  #
#*# # # #*# #
#s *  *  2  #
# # #*# # # #
#   *  1    #
# #*# # # # #
#    *   *  #
#*# # # # #*#
# **    *   #
# # # #1#*# #
#    *    * #
# #*# # # # #
#    * 3*  *#
# # # # #*# #
# ***  *    #
# # #1# # #*#
#3    * *   #
# # #*#*# # #
#*  2  **   #
# # # # #*# #
#  **   **  #
#############