1 13 31
###############################
#p     ** *  1 * 2 s  * * *   #
# # # #*# # #*#*# # # #*#*#*# #
#  **     ***  *  1   * 2 * * #
# # # # # #*# # #*#*# # # # #*#
#f         * **  *  x   4     #
# # # # # # # # # #*# #*# # # #
#*  *      *  *      *        #
# # # # #*# # # #*#*# # # # # #
#*    **  *       *           #
# #*# # # # # # #*# # # # # # #
#           b   *  *          #
###############################