2 15 31
###############################
#p     ** *  3 * 2 s  *  *    #
# *## #*# # #*#*# # # # # #*# #
#  **     ***  *  1   *   *   #
# # # # # #*# # #*#*# # # # #*#
# *   **   * b*1 *  x         #
# #   #*# # # # # ## ## * # # #
#*  *   2  *  *   *  *   1  * #
# # # # #*# # # #*# # # #*# # #
#*    3*  *   *     2 ****    #
# #*# # # # #*# #*# #*# #*# # #
#     1     *   ***       *   #
# # # #* # #*## #*# #*# #*# # #
# *# #  * f  2# *   # * # # # #
###############################