1 15 23
#######################
#p  *  *t *  1 * 2 s  #
# # # # # # #*#*# # # #
#  **     ***  *  1   #
# # # # # #*# # #*#*# #
# *   **    *  *1 *  x#
# # f # # # #t# # #*# #
#*  *   2  *  *   *  *#
# # # # #*# # # #*# # #
#*    **  *   *   **2 #
# #*# # # # #*# #*# #*#
#     1     * 4 ***   #
#  *t#* # # #*# #*# #*#
# *# #  *   *2# * d # #
#######################