1 15 31
###############################
#p w*  *t *    *   s  *  *    #
# #   #t# # #*#*# # # # # #*# #
#bb**     ***  *      *   *   #
#f# # # # #*# # #*#*# # # # #*#
# *   **   s* b*  *  x        #
# #   # # # # # # #*# #*# # # #
#*  *      *  *   *  *      * #
# # # # #*# # # #*# # # #*# # #
#*    **  *   *   **  *#*     #
# #*# # # # #*# #*# #*# #*# # #
#           *   ***       *   #
#  * #* # # #*# #*# #*# #*# # #
# *# #  * f   # *   # * # # # #
###############################