1 13 13
#############
#p  * * *  1#
# # #*#*#*# #
#   * * * * #
# # # # # #*#
#f*   1     #
# # #*# # # #
#* *    **x #
# # # #*# # #
#*  * *  1 *#
# # # # # # #
# * 1*     *#
#############
