1 15 31
###############################
#p w*  *t *  1 * 2 s  *  *    #
# #   #t# # #*#*# # # # # #*# #
#  ** 555 ***  *  1   *   *   #
#f# # # # #*# # #*#*# # # # #*#
# *   ** 6 s* b*1 *  x        #
# # 6 # # # # # # #*# #*# # # #
#*  * 6 2  *  *   *  *      * #
# # # # #*# # # #*# # # #*# # #
#*    **  *   *   **2 *#*     #
# #*# # # # #*# #*# #*# #*# # #
#     1     *   ***       *   #
#  * #* # # #*# #*# #*# #*# # #
# *# #  * f  2# *   # * # # # #
###############################