3 15 31
###############################
#p     ** *  3    s  *  *     #
# *## #*# # #*#*# # # # # #*# #
#  **  2   ***  *  1   *   *  #
# #b# # # #*# # #*#*# # # # #*#
# *  4 *   * b*1 *  x         #
# # * #*# # # # *# ## #*# # # #
#* *   2  *  4*   *  *   1  * #
# # # # # # # # #*# # # #*# # #
#*    3*  *   *     2 ** *    #
# #*# # # # #*# #*# #*# #*# # #
#     1     *   ***       *   #
# # # #* # #*## #*# #*# #*# # #
# *# #  * f  2# *   # * # # # #
###############################