2 15 31
###############################
#p     ** *  3 * 2 s  *  *  t #
# *## #*# # #*#*# # # # # #*# #
#  **     ***  *  1w  *   *   #
# # # # # #*# # #*#*# # # # #*#
# *   **   * b*1 * t 3   *    #
# # # #*# # # # # ## ## x # # #
#*  *   2  *  *   *  *   1  * #
# # # # #*# # # #*# # # #*# # #
#*    3* t*   *     2 ****    #
# #*# # # # #*# #*# #*# #*# # #
#t    1     *  t***       *   #
# # # #* # #*## #*# #*# #*# # #
# *# #  * f  2# *   # * # # # #
###############################