1 15 21
#####################
#p  b* #  *# *1  * *#             
#  * s #* 2  *f #  f#
#  *  *  * 3 *    *x#
#*   *  f *  *#  ** #
#2  * #  *    1 *s *# 		    
#   b *  *  2 **    #                   
#  *    * * *   **  #                
#  #   #3     ** *  #       
#    **    b    *  1#       
#  *  #    *   *    #   
#  s   # ## f   **  #     
#   #   *     *     #                    
#   *   #   # *     #                   
#####################