3 15 31
###############################
#p     f* *  3    s t*  * 6   #
# *## #*# # #*#*# # # # # #*# #
#  **  2   t**  *  1 3 *   * w#
# #b# # # #*# # #*#*# # # # #*#
# *  4 *   * b*1 *  ** 5  4   #
# # * #*# # # # *# ## #t# # # #
#* *   2  *  4*   * 6*   1  * #
# # # # # # # # #*# # # #*# # #
#*  d 3* t*1 s*  5  2 ** *   t#
# #*# # # # #*# #*# #*# #*# # #
# 6   1  3  *   ***   x   *   #
# # # #* # #*## #*# #*# #*# # #
# *#t#  * f  2# * 5 # * # # # #
###############################