1 13 13
#############
#p f    **2 #
# # # #*# # #
#sb x  2 *1 #
#*# # # #*# #
#s *3 *  24 #
# # #*# # # #
# 3 *  1 4  #
# #*# # # # #
#1 *4 *2 2  #
# # #*# # # #
#  *3 *1 2  #
#############